# # # # # # # # # # # # # # # # # # # # # # # 
#           #           #                   # 
#   # # # # #   #   #   #   # # # # #   #   # 
#           #   #   #   #       #       #   # 
#   # # #   #   #   #   # # # # #   # # #   # 
#   #   #   #   #   #       #       #   #   # 
#   #   #   #   #   # # #   #   # # #   #   # 
#       #       #       #       #           # 
# # # # # # #   # # #   # # # # #   # # # # # 
#           #       #       #               # 
#   # # #   # # # # # # #   #   # # # # # # # 
#       #   #         S #   #   #           # 
# # #   #   #   # # # # #   #   #   # # #   # 
#   #   #   #           #   #   #       #   # 
#   #   #   # # # # #   #   # # # # #   #   # 
#       #       #       #               #   # 
#   # # # # #   #   # # # # # # #   # # #   # 
#       #   #   #   #           #       #   # 
# # #   #   #   #   #   # # #   #   # # #   # 
# E #       #       #   #       #   #       # 
#   # # #   # # # # #   #   # # # # #   #   # 
#                       #               #   # 
# # # # # # # # # # # # # # # # # # # # # # # 